//MAP CONVERTED BY dmm2tgm.py THIS HEADER COMMENT PREVENTS RECONVERSION, DO NOT REMOVE
"q" = (
/obj/docking_port/stationary/cryo_shuttle_deep{
	dir = 1;
	dheight = 4;
	dwidth = 3;
	height = 5;
	width = 7;
	},
/turf/open/space/basic,
/area/space)
"C" = (
/obj/effect/landmark/navigate_destination,
/turf/open/space/basic,
/area/space)

(1,1,1) = {"
C
q
"}
