//MAP CONVERTED BY dmm2tgm.py THIS HEADER COMMENT PREVENTS RECONVERSION, DO NOT REMOVE
"a" = (
/turf/template_noop,
/area/template_noop)
"b" = (
/obj/machinery/door/airlock/shuttle{
	name = "Arrival Shuttle Airlock"
	},
/obj/effect/turf_decal/stripes/line{
	dir = 8
	},
/obj/effect/turf_decal/stripes/line{
	dir = 4
	},
/obj/structure/fans/tiny,
/turf/open/floor/iron/white,
/area/shuttle/arrival)
"k" = (
/obj/effect/turf_decal/tile/neutral/half{
	dir = 8
	},
/turf/open/floor/iron/edge{
	dir = 8
	},
/area/shuttle/supply)
"m" = (
/obj/effect/mapping_error,
/turf/open/floor/iron,
/area/shuttle/supply)
"q" = (
/obj/machinery/power/shuttle_engine/heater,
/obj/structure/window/reinforced/survival_pod/spawner/directional/north,
/turf/open/floor/plating/airless,
/area/shuttle/supply)
"s" = (
/turf/closed/wall/mineral/titanium/survival/pod,
/area/shuttle/supply)
"x" = (
/obj/structure/chair/comfy/shuttle{
	dir = 1
	},
/obj/effect/turf_decal/box,
/obj/effect/turf_decal/tile/neutral/half{
	dir = 1
	},
/turf/open/floor/iron/edge{
	dir = 1
	},
/area/shuttle/supply)
"y" = (
/obj/machinery/power/shuttle_engine/propulsion/left,
/turf/open/floor/plating/airless,
/area/shuttle/supply)
"A" = (
/obj/structure/chair/comfy/shuttle{
	dir = 1
	},
/obj/effect/turf_decal/bot/left,
/obj/effect/turf_decal/tile/neutral/anticorner,
/turf/open/floor/iron/corner{
	dir = 1
	},
/area/shuttle/supply)
"C" = (
/obj/structure/closet/firecloset,
/obj/effect/turf_decal/tile/neutral/anticorner{
	dir = 4
	},
/turf/open/floor/iron/corner{
	dir = 8
	},
/area/shuttle/supply)
"I" = (
/obj/machinery/power/shuttle_engine/propulsion,
/turf/open/floor/plating/airless,
/area/shuttle/supply)
"J" = (
/obj/machinery/computer/emergency_shuttle,
/turf/open/floor/iron,
/area/shuttle/supply)
"L" = (
/obj/effect/spawner/structure/window/survival_pod,
/turf/open/floor/plating,
/area/shuttle/supply)
"O" = (
/obj/structure/chair/comfy/shuttle{
	dir = 1
	},
/obj/effect/turf_decal/tile/neutral/half,
/turf/open/floor/iron/edge,
/area/shuttle/supply)
"Q" = (
/obj/machinery/power/shuttle_engine/propulsion/right,
/turf/open/floor/plating/airless,
/area/shuttle/supply)
"V" = (
/obj/structure/closet/emcloset,
/obj/effect/turf_decal/tile/neutral/anticorner{
	dir = 1
	},
/turf/open/floor/iron/corner,
/area/shuttle/supply)
"X" = (
/obj/structure/chair/comfy/shuttle{
	dir = 1
	},
/obj/effect/turf_decal/bot/right,
/obj/effect/turf_decal/tile/neutral/anticorner{
	dir = 8
	},
/turf/open/floor/iron/corner{
	dir = 4
	},
/area/shuttle/supply)
"Z" = (
/obj/effect/turf_decal/tile/neutral/half{
	dir = 4
	},
/turf/open/floor/iron/edge{
	dir = 4
	},
/area/shuttle/supply)

(1,1,1) = {"
a
s
s
L
s
s
s
"}
(2,1,1) = {"
s
s
V
k
X
q
y
"}
(3,1,1) = {"
L
J
x
m
O
q
I
"}
(4,1,1) = {"
s
s
C
Z
A
q
Q
"}
(5,1,1) = {"
a
s
s
b
s
s
s
"}
