//MAP CONVERTED BY dmm2tgm.py THIS HEADER COMMENT PREVENTS RECONVERSION, DO NOT REMOVE
"q" = (
/obj/machinery/computer/shuttle/cryo_console{
	dir = 1;
},
/turf/closed/wall,
/area/station/hallway/secondary/entry)

(1,1,1) = {"
q
"}
